#############
#           #
# #####     #
#   s # #  e#
#       #   #
#  ######   #
#     #     #
#           #
#############